4 4
WWWWWWWWWW
WCCCWCCCWW
WCDCCCDCCW
WDCDCCCCWW
WWDCCCDDCW
WDCCCCCCCW
WDCDCCCDCW
WCCCDDDDWW
WCCWCCWCCW
WWWWWWWWWW