4 4
WWWWWWWWWW
WCCCCCCCCW
WCCCCCCCCW
WCCCCCCCCW
WCCCCCCCCW
WCCCCCCCCW
WCCCCCCCCW
WCCCCCCCCW
WCCCCCCCCW
WWWWWWWWWW